NO textures/wolfenstein/grey_stone.png
SO textures/wolfenstein/purple_stone.png
WE textures/wolfenstein/red_brick.png
EA textures/wolfenstein/wood.png

F 18,53,25
C 153,204,255

111111111111
100000000001
100000000001
1111111111110
10S0000000010
1000011100010
1000000000010
1111111111110
