NO textures/north.png

SO textures/south.png

EA 				textures/east.png


F 220,100, 245
C 255, 255, 0


WE textures/west.png                  


111111111111111111111111111111111111111111111111111111111111
1N0000000000000000000000000000000000000000000000000000000001
111111111111111111111111111111111111111111111111111111111111
1