NO textures/north.png

SO textures/south.png

EA textures/east.png

F 220,100,21
C 225,30, 4

WE textures/west.png
                     
                     
        1111111111111111111111111    
    	100000000011000000000N001
	    1111000001110000000000111    
	10000000000000000011111111111
111111111011000001110000000000001
100000000011000001110111111111111
  1111011111111101110000100000001
   111101111111110111010100101111
1100000011010101110000001011
10000000000000001100000010111
10000000000000001101010010001
110000011101210111110111100111
11110111 1110101 101111010001
11111111 1111111 111111111111
