NO textures/north.png
SO textures/south.png
WE textures/west.png
EA textures/east.png

F 255,255,255
C 0,0,0

        11111111111111111110111110
        10000000001100000000000010
        00110000011100000000000010
        1001000000000000000000000
111111111011000001110000000000001
100000000011000001110000011111111
11110111111111011100000010001
11110111111111011101010010001
11000000110101011100000010001
10000000000000001100000010001
10000000000000001101010010001
1100000111010101111101111N0111
11110111 1110101 101111010001
11111111 1111111 111111111110
