NO textures/wolfenstein/grey_stone.png
SO textures/wolfenstein/purple_stone.png
WE textures/wolfenstein/red_brick.png
EA textures/wolfenstein/wood.png

F 18,53,25
C 153,204,255

        11111111111111111111111110
        10000000001100000000000010
        10110000011100000000000010
        1001000000000000000000001
111111111011000001110000000000001
100000000011000001110000011111111
11110111111111011100000010001
11110111111111011101010010001
11000000110101011100000010001
10000000000000001100000010001
10000000000000001101010010001
11000001110101011111011110N0111
11110111 1110101 101111010001
11111111 1111111 111111111110
