NO textures/north.png
SO textures/south.png
WE textures/west.png
EA textures/east.png

F 255,255,255
C 0,0,0

        1111111111111111111111111
        1000000000110000000000001
        1011000001110000000000001
        1001000001000000000000001
111111111011000001110000000000001
100000000011000001110000011111110
11110111111111011100000010001
11110111111111011101010010001
11000100110101011100000010001
10001010000000000000000010001
10000100000000001101010010001
11000001110101011111011010W0111
11110111 1110101 111111010001
11111111 1111111 11111111111
